111111111111111
100C00001100001
110011000101111
10001001001C011
101000101011001
100100110000001
1P0010001011001
10001000E110001
111111111111111
