1111111
100C0P1
11E0111
1111011
