11111111
1000001
1P00E0C
10001
1111
