1111111
10100E1
1C100P1
1111111
