111111
1E00A1
1C0001
1000P1
111111
