1111111
1001001
10111C1
1001PE1
1111111
