1111111
1001001
10111C1
1000PE1
1111111
