111111111111111
100C0001000C001
110011000101111
10001001001C011
101000101011001
100100110C00001
1P0010001011001
10001000E110001
111111111111111
