111111111111111
100C0001000C001
110011000101111
10001001001C011
101000110011001
100100110C00001
1P0010000011001
10001000E100001
111111111111111
