111111111111111
1C0000C00000C01
101110111011101
100000000000001
111011111110111
100000C00000001
111011111110111
1P00000000E0001
111111111111111
